6,6,6,6,6,6,6,6,6,6,6,6,6,6,6,6,6,6,6,6,6,6,6,6,6,6,6,6,6,6,6,6,6,6,6
6,4,4,4,,,,,3,3,3,3,,,,,,,,,,,,,,,,,,,,,,,6
6,,,,,,,4,4,4,4,,,,,,,,,,,,,,,,,,,,,,,,6
6,,,,,,,4,4,4,4,,,,,,3,3,,,,3,3,,,,,4,4,4,4,,,,6
6,,,,,,,4,4,,,4,4,4,,,,,,,,3,3,,,,,4,4,4,4,,,,6
6,,,,,,,4,4,,,4,4,4,,,,,,,,3,3,,,,,4,4,4,4,,,,6
6,,,,,,,4,4,,,,,,,,,,,,,3,3,,,,,,,,,,,,6
6,,,,,,,4,4,,,,,,,,,3,3,,,3,3,,,,,,,,,,,,6
6,,,,,,,4,4,,,,,,,,,2,2,,,3,3,,,,,,,,,,,,6
6,,,,,2,2,,,3,3,3,,,,,,2,2,,,3,3,,,,,,,,,,,,6
6,,,,,2,2,,,3,3,3,,,,,,,,4,4,3,3,,,,,,,,,,,,6
6,3,3,3,,,,,,3,3,3,,,,,,,,4,4,3,3,,,,,,,,,3,3,3,6
6,5,5,3,0,,,,,3,3,3,,,,,,,,3,3,3,3,,,,,,,1,,3,5,5,6
6,5,5,3,,,,,,3,3,3,,,,,,,,3,3,3,3,,,,,,,,,3,5,5,6
6,3,3,3,,,,,,,2,2,,,,,4,4,,,,,,,,,,,,,,3,3,3,6
6,,,,,,,,,,2,2,,,,,4,4,,,,,,,,,,,,,,,,,6
6,,,,,,,,4,4,,,,,,,,,,,,,,,,,,,,,,,,,6
6,,,,,,,,4,4,,,,,,,,,,,,,,,,4,4,,,,,,,,6
6,,,,,,4,4,,,3,3,3,,,,,,,,,,,,,4,4,,,,,,,,6
6,,,,,,4,4,,,3,3,3,,,,,,,,,,,,,4,4,4,4,4,4,4,,,6
6,,,,2,2,2,2,,,3,3,3,,,,,,,,,,,,,4,4,4,4,4,4,4,,,6
6,,,,2,2,2,2,,,3,3,3,,,,,,,,,,,,,2,2,2,2,2,4,4,,,6
6,,4,4,4,4,4,,,,3,3,3,,,,,,,,,,,,,2,2,2,2,2,4,4,,,6
6,,4,,,,,,,,3,3,3,,,,,,,,,,,,,2,2,2,2,2,4,4,,,6
6,,4,,,,,,,,3,3,3,,,,,,,,,,,,,2,2,2,2,2,4,4,,,6
6,4,4,,,,,,,,3,3,3,,,,,,,,,,,,,,,,,,,,,,6
6,,,,,,,,,,,,,,,,,,,,,,,,,,,,,,,,,,6
6,6,6,6,6,6,6,6,6,6,6,6,6,6,6,6,6,6,6,6,6,6,6,6,6,6,6,6,6,6,6,6,6,6,6
